8 12
BBBBBBBBBBBB
BNPNNNNPNNNB
BNNNNNNNNNNB
BNNNWWWNNNNB
BNNNNNNNNNNB
BNNNNNNNNNNB
BNNNNNNNNNNB
BBBBBBBBBBBB